achachaw	interj.
achallaw	interj.
achikyay	v. impers.
achiy	v. intr.
achhuy	v. intr.
achira	s.
achita	s.
achkha	adv.
achura	s.
aka	s.
akachaw	interj.
akakaw	interj. Cuz.
akakllu	s.
akapa	adj.
aka-tanqa	s.
akay	v. intr.
aklla	s.
aklla-wasi	s. arc.
akllay	v. tr.
akllu	adj.
aku	s.
aku	s. Aya.
akulliy	v. tr. Cuz.
akuy	v. tr. Aya.
alalaw	interj.
alpaka	s.
allachu	s.
allay	v. tr.
allichakuy	v. intr.
allichay	v. tr.
allillamanta	adv.
allin	adj.
allinyay	v. intr. Aya.
alliq	adj.
alliyay	v. intr.
allpa	s.
allqu	s.
allquchay	v. tr.
allwiy	v. tr.
ama	adv.
amachay	v. tr.
amankay	s.
amaru	s.
amiy	v. intr.
amuqllu	s.
ana	s.
ananaw	interj.
anaku	s. arc.
anaq	adj.
ancha	adv.
anchiy	s. / v. intr.
anchhuy	v. intr.
anka	s.
anku	s. / adj. fig.
anta	s. / adj.
antaqa	s.
antara	s.
antarpakuy	v. intr. Aya.
anti	s.
anti-suyu	s.
anqas	adj.
anqusay	v. tr.
anukay	v. intr.
anyanakuy	v. rec.
anyay	v. tr.
añallaw	interj.
añas	s.
añu	s. Cuz.
apachita	s.
apachiy	v. tr.
apamuy	v. tr.
apay	v. tr.
api	s.
apichu	s.
aptay	s. / v. tr. Cuz.
aptiy	v. tr. Aya.
apu	s. / arc.
apyay	v. intr. Aya.
aqarway	s. Aya.
aqnuy	v. tr. Cuz.
aqtuy	v. tr.
aqu	s.
aqha	s.
arariwa	s.
ari	adv.
arkuy	v. tr.
armay	v. tr.
arwi	adj.
arwiy	v. tr.
as	adv.
as	adv.
asichikuq	s.
asiy	v. intr.
aslla	adv.
asnaq	adj.
asnay	v. intr.
asnu	s.
aspiy	v. tr.
astay	v. tr.
astiy	v. tr.
asuy	v. intr.
aswan	adv.
ataqu	s.
atataw	interj.
ataw	s.
atinakuy	v. rec.
atipay	v. tr.
atiy	v. tr.
atuq	s.
aw	adv. Aya.
awa	s.
away	v. tr.
awki	s. / arc.
awniy	v. tr. Aya.
awqa	s.
aya	s.
ayachay	s. Aya.
aycha	s.
ayllu	s.
ayni	s.
ayniy	v. tr.
aypay	s. Cuz. / v. tr.
aypuy	v. tr. Aya.
ayqiy	v. intr.
ayrampu	s.
aysay	v. tr.
aytiy	s. Cuz.
aywiy	v.
chaka	s.
chakay	v. tr.
chakatay	v. tr.
chaki	s.
chaki-muqu	s.
chaki-sinqa	s.
chaki-taklla	s.
chakmay	v. tr.
chakra	s.
chaku	s.
challpuy	v. tr.
challwa	s.
challway	v. tr.
chamchay	v. tr. Aya.
chamqay	v. tr.
chamra	adj. Aya.
chanin	adj.
chaninchay	v. tr.
chapchay	v. intr. Aya.
chaplay	v. tr. Aya.
chapra	s.
chapuy	v. tr.
chaqay	dem. Cuz.
chaqay	v. tr. Aya.
chaqlla	s.
chaqnay	v. tr.
chaquy	v. tr.
chaski	s.
chaskiy	v. tr.
chawcha	s.
chawpi	s.
chay	pron.
chayay	v. intr.
chaykama	adv.
chaymanta	conect.
chayna	conect.
chayqa	conect.
chayraq	adv.
chicharu	s.
chichu	adj.
chichuyay	v. intr.
chikachay	v. tr.
chikchi	s.
chikchiy	v. intr.
chikuchay	v. tr. Aya.
chilina	s.
chilliku	s. Aya.
chimlliykachay	v. intr. Cuz.
chimpa	s.
chimpay	v. intr.
chimpu	s.
chimqiy	v. intr. Aya.
china	s.
chinanayay	v. intr.
chinchay-suyu	s.
chinkay	v. intr.
chipipipiy	v. intr.
chipru	adj. Aya.
chiqa	s.
chiqachay	v. tr.
chiqniy	v. tr.
chirapa	s. Cuz.
chiraw	s.
chiri	s. / v. intr.
chirimuya	s.
chiririnka	s.
chiriyay	v. tr.
chita	s. Cuz.
chiwaku	s.
chiwchi	s.
chiwillu	s.
chuchaw	s.
chuchuqa	s.
chuchuy	s. Aya.
chukcha	s.
chukchu	s.
chukchuy	v. intr.
chuki	s.
chuku	s.
chullunku	s. / Var. P.
chullunkuy	v. intr.
chulluy	v. intr. Aya.
chumchikuy	v. intr. Aya.
chumpi	s.
chunka	num.
chunku	s. Cuz. / Aya.
chunyay	v. intr. Aya.
chunniq	s. Aya.
chupa	s.
chupi	s.
chuqay	v. tr.
chuqi	s.
chuqllu	s.
churakuy	v. tr. / Fig.
churay	v. tr.
churi	s.
churiyay	v. tr.
churkuy	v. tr.
chusi	s. Cuz.
chutay	v. tr. / Fig.
chutu	s.
chutuy	v. tr.
chhalla	s.
chhapchiy	v. tr.
chhaqruy	v. tr.
chhika	adv.
ch'aka	adj.
ch'aki	adj.
ch'akiy	v. intr.
ch'allay	v. tr.
ch'ampa	s.
ch'aqchuy	v. tr.
ch'aqlay	v. tr. Cuz.
ch'aqwa	s.
ch'arki	s. / Fig.
ch'aska	s.
ch'awa	s.
ch'awar	s. Cuz.
ch'away	v. tr.
ch'ichiy	v. tr.
ch'iki	s.
ch'iklluy	s. Cuz. / v. tr.
ch'illikutu	s. Cuz.
ch'illpiy	v. tr.
ch'illu	s. / adj.
ch'imlliy	Cuz. v. intr.
ch'inniq	s.
ch'inyay	v. intr. Cuz.
ch'ipa	s.
ch'iptiy	v. tr.
ch'iqchi	adj.
ch'iqiy	v. tr.
ch'iqta	s.
ch'iqtan	s.
ch'iqtay	v. tr.
ch'isi	adv.
ch'isiyay	v. intr.
ch'iya	s.
ch'uklla	s.
ch'ulla	adj.
ch'ulli	s.
ch'ullpi	s.
ch'ullu	s.
ch'umay	v. tr.
ch'umpi	adj.
ch'unchu	s.
ch'unchul	s.
ch'uñu	s.
ch'upa	s. Cuz.
ch'upu	s. / adj.
ch'uqni	s. Cuz.
ch'uru	s.
ch'usiq	s.
ch'usaq	adj. Cuz.
ch'uspa	s.
ch'uspi	s.
ch'ustiy	v. tr.
ch'usu	adj.
ch'uya	adj.
hacha	s.
hach'u	s.
hach'uy	v. tr.
haka	adj. Aya.
hakapakuy	v. intr. Aya.
haku	v. def.
hak'u	s. Cuz.
hallmay	v. tr.
hamank'ay	s.
hamak'u	s.
hamawt'a	s.
hamch'i	s.
hamka	s.
hamkay	v. tr.
hamp'atu	s.
hampi	s.
hampiy	v. tr.
hampuy	v. intr.
hamut'ay	v. tr.
hamuy	v. intr.
hanan	s.
hanaq	adv.
hank'a	adj. Cuz.
hank'ay	v. tr. Cuz.
hank'u	s. Cuz.
hanlla	adj. Aya.
hanllapakuy	v. intr.
hantaray	v. intr. Cuz.
hanuk'ay	v. intr. / Fig.
hap'iy	v. tr.
hapkay	v. tr.
hapnay	v. intr.
hapt'ay	v. tr.
haqay	pron.
haqiy	v. tr.
harawi	s. Cuz. / Aya.
hark'ay	v. intr.
hasp'iy	v. tr.
hast'iy	v. tr. Cuz.
hasut'i	s.
hatariy	v. intr.
hatuchaq	adj.
hatun	adj.
hatunyay	v. intr.
hat'alliy	v. intr. Cuz.
hat'aqu	s. Cuz.
hawa	adj. Cuz. / adv.
hawas	s.
hawka	s.
haya	adj.
hayay	v. tr.
hayaq	s.
hayk'a	pron.
hayk'ap	pron.
haykuy	v. intr. Cuz.
haylli	s.
haylliy	v. tr.
haymay	v. tr.
haypay	v. tr.
hayt'a	s.
hayt'ay	v. tr.
hayway	v. tr.
hichpay	v. intr.
hich'ay	v. tr.
hikchuy	v. intr. Aya.
hikutay	v. tr.
hik'iy	v. tr.
hik'iy	v. intr. Cuz.
hillp'uy	v. tr.
hina	adv.
hinakuy	v. tr.
hinaspa	conect.
hinay	v. tr.
hiq'ipay	v. intr.
hirq'i	s.
hisp'ay	s. / v. intr.
hucha	s.
huchallikuy	v. intr.
huch'uy	adj.
huk	num.
hukllaway	v. tr.
huk'ucha	s.
humint'a	s.
hump'i	s.
hump'iy	v. intr.
hunt'a	adj.
hunt'ay	v. tr.
huntuy	v. tr. Aya.
huñiy	v. tr.
huñunakuy	s.
huñuy	v. tr.
huqariy	v. tr.
huq'u	adj.
huq'ullu	s.
hurquy	v. tr.
husk'ay	v. tr. Cuz.
husut'a	s.
hutk'u	s. Cuz.
icha	conect.
ichiy	v. intr.
ichuq	s. Aya.
ichhu	s.
ikiy	v. tr.
illapa	s.
illariy	v. intr.
illaway	v. tr.
illay	v. intr. Cuz. / Aya.
ima	pron. interrog.
imanay	v. tr.
imayna	interrog.
inchik	s.
inka	s.
inkill	s.
inqhipakuy	v. intr. Cuz.
inti	s.
inti-raymi	s.
iñiy	v. tr.
ipa	s. Cuz.
iphu	s.
iqipay	v. intr. Aya.
isanka	s.
iskay	num.
iskaychay	v.
isku	s.
iskuy	v. tr. Aya.
ismuy	v. intr.
ispay	s. Aya. / v. tr.
isqun	num.
itana	s. Aya.
itha	s.
kachariy	v. tr.
kacharpariy	v. tr. / s.
kachay	v. tr.
kachi	s.
kachkay	v. cop.
kallapa	s. Aya.
kallchay	s. Cuz.
kallpa	s.
kallpay	v. intr. Aya.
kamay	v. tr.
kamachikuy	s. / v. tr.
kamcha	s.
kanan	adv. Aya., Ancash
kanay	v. tr. Cuz.
kancha	s.
kancha-lawa	s.
kaniy	v. tr. / Fig.
kanka	s.
kankay	v. tr.
kañay	v. tr. Aya.
kapuy	v. tr.
kaqlla	adv.
karchay	s. Aya. / v. tr.
karu	adv.
kasaray	v. intr.
kaspa	s. Aya.
kasuy	v. tr.
katari	s.
katkatatay	v. intr. Aya.
kawallu	s.
kawiltu	s.
kawitu	s.
kawpuy	v. tr.
kawsay	s. / v. intr.
kawsariy	v. intr.
kay	pron. dem.
kay	v. cop.
kichay	v. tr.
kichka	s.
kiki	pron.
killa	s.
killi	s. / Aya.
killwiy	v. tr. Aya.
kimsa	num.
kinranpa	adv.
kinray	s. / v. intr.
kirkinchu	s.
kirpay	v. tr.
kiru	s. / s. Cuz.
kiswar	s.
kiwna	s.
kuchkuy	v. tr.
kuchpay	v. intr. Aya.
kuchuchu	s. Cuz.
kuchus	s. Aya.
kuchuy	v. tr.
kuhichu	ant. / s. Cuz.
kuka	s.
kuki	s.
kukuli	s.
kullku	s.
kumpay	v. tr.
kunan	adv. Cuz.
kunay	v. tr.
kunka	s.
kunti-suyu	s.
kuntur	s.
kuraq	s.
kurku	adj. Aya. / Cuz. s.
kuru	s. / adj.
kurur	s.
kururay	v. tr.
kurus	s.
kusa	adj.
kusay	v. tr.
kusi	adj.
kusi-kusi	s.
kusikuy	s. / v. intr.
kuska	adj. / adv.
kutama	s.
kutay	v. tr.
kuti	s.
kutimuy	v. tr.
kutichiy	v. tr.
kutipay	v. tr.
kutiy	v. intr.
kuyti	s.
kuyuy	v. intr.
khachkay	v. tr.
khachuy	s.
khakyay	v. tr.
khallka	s.
khamuy	v. tr. Cuz.
khanka	s. Cuz.
kharka	s. / Fig.
khatatatay	v. intr. Cuz. / Aya.
khawa	s.
khaya	s.
khipu	s. / arc.
khipuy	v. tr.
khuchi	s. / Fig.
khuyapay	v. tr.
khuyay	s. / v. tr.
k'achampa	s. Cuz.
k'akara	s.
k'akchay	v. tr.
k'akichu	s.
k'aklla	s. Cuz.
k'allampa	s. Cuz.
k'allana	s.
k'allma	s.
k'allmay	v. tr.
k'amiy	v. tr.
k'anchay	s. / v. intr.
k'anka	s. Cuz.
k'antiy	v. tr. Cuz.
k'apka	v. tr.
k'askay	v. tr. Cuz.
k'aspi	s.
k'ayra	s.
k'ichki	adj. / s.
k'ikllu	adj.
k'illinchu	s.
k'ipchan	s.
k'iptay	v. tr.
k'ikuchikuy	s. / v. tr.
k'illimsa	s. Cuz.
k'intu	s.
k'iraw	s.
k'iri	s.
k'iriy	v. tr.
k'ita	adj.
k'uchi	adj. Cuz.
k'uchu	s.
k'ullu	s. / Fig.
k'umu	adj.
k'umuy	v. intr.
k'urpa	s.
k'usillu	s.
k'uspa	adj. Cuz.
k'utu	adj.
k'utuy	v. tr.
k'uychi	s. Cuz.
k'uyka	s.
k'uytuy	v. intr. Cuz.
lampa	s.
lampiy	v. tr.
lamras	s.
lani	s. Aya.
lansay	v. tr.
laptay	v. tr.
lapuy	v. tr. Aya. / Cf.
laqay	v. tr.
laqla	adj. Aya.
laqyay	v. tr. Aya.
laqha	adj. Cuz.
laranha	ant. / s. Cuz.
laru	s.
lasta	s. Aya.
lastay	v. impers. Aya.
latanus	s.
latapa	adj. Aya.
lawa	s.
laway	v. tr. / Fig.
lawsa	s. Aya.
lawus	s.
layqa	s.
layqay	v. tr.
lichi	s.
lichun	s.
limun	s.
liqichu	s. Cuz.
liqlis	s. Aya.
lirpu	s.
lisas	s. Cuz.
liwi	s.
liwru	s.
liyiy	v. tr.
lukma	s.
luqlu	s. Aya. / Fig.
luru	s.
luychu	s.
llaki	s.
llakikuy	v. intr.
llaklla	adj.
llalliy	v. tr.
llama	s.
llamkhay	v. tr.
llamk'ay	s. / v. tr.
llamp'u	adj.
llamp'uyay	v. intr.
llamt'a	s.
llank'i	s. Cuz.
llanthu	s.
llanthuy	v. intr.
llañu	adj. / Fig.
llapa	pron.
llapch'ay	v. tr.
llapch'iy	v. tr.
llapsa	adj.
llaphiy	v. tr.
llap'i	s. Cuz.
llaqllana	s.
llaqllay	v. tr.
llaqta	s.
llaqway	v. tr.
llasa	adj.
llasay	v. intr.
llat'ay	v. tr.
llawi	s.
llawsa	s. Cuz.
llika	s.
llik'i	adj.
llik'iy	v. tr.
lliklla	s.
llimp'ay	v. tr.
llinka	s. Aya.
llipipiy	v. intr.
llipt'a	Aya.
llipyaq	s.
llipyay	v. impers.
lliw	s.
lluchkha	adj.
lluchkhay	v. intr.
lluch'uy	v.
llukllu	adj.
lluk'iy	s. Cuz. / v. tr.
llulla	adj.
llullakuy	v. tr.
llullu	adj.
llumchuy	s. Aya.
llump'ay	adj.
llunk'iy	v. tr.
llunk'uy	v. tr.
lluptiy	v. intr. Aya.
lluqlla	s.
lluqllu	s. / Fig.
lluqsiy	v. intr.
lluqhay	v. tr.
lluq'i	adj.
llusiy	v. tr.
lluspiy	v. tr.
llusp'iy	v. tr. Cuz.
lluthu	s. Cuz.
llut'ay	v. tr.
lluy	s.
machay	s. / v. intr.
machka	s. Aya.
machu	adj. / Fig.
machuyay	v. intr.
mach'aqway	s.
mach'ay	s.
maki	s.
makipuray	v. tr. Aya.
mak'alliy	v. tr.
malta	adj.
mallay	v. intr.
malliy	v. tr.
mallki	s. / arc.
mallqu	s.
mama	s.
mamacha	s.
mamaq	s.
mana	adv.
manchay	s. / v. tr.
maniyay	v. tr.
manka	s.
mansana	s.
manu	s. / adj.
manuy	v. tr.
mañay	v. tr.
mapa	s.
map'akuy	v. intr.
maqana	s.
maqay	v. tr.
maqchhiy	v. tr. Cuz. / Aya.
maqlla	adj.
maqma	s. Aya. / adj. Cuz.
maqt'a	s.
maran	s. Cuz.
maray	s. Aya.
marka	s.
marq'ay	v. tr.
masa	s.
masa	s. Aya.
masay	v. tr.
masi	s.
maskhay	v. tr.
mast'ay	v. tr.
masu	s.
maswa	s. Aya.
mata	s.
matara	s.
mati	s.
mat'i	s. Cuz.
mawk'a	adj.
mawk'ayay	v. intr.
mawla	adj.
may	pron.
maychhika	pron.
mayllay	v. tr. Aya.
maylliy	v. tr. Cuz.
mayna	pron.
mayqan	pron. / Aya.
mayqin	pron.
mayt'uy	v. tr.
mayu	s.
mich'a	adj.
michiy	v. tr.
michka	s.
mich'uy	v. tr. Cuz.
mikhuy	s. / v. tr.
milkapa	s. Aya.
millakuy	v. tr.
millay	adj.
millma	s.
millp'uy	v. tr.
millqhay	s. / v. tr.
millwa	s.
minchha	s.
mink'a	s.
mink'ay	s. / v. tr.
miray	v. intr.
mirkha	s.
misi	s.
miskhuy	v. tr.
misk'i	adj.
misk'ichay	v. tr.
misk'ipa	s.
mismiy	v. intr.
misti	adj.
mit'a	s. / arc.
mitma	s.
mitk'ay	v. intr.
mitu	s. Aya.
miyu	s. Cuz.
muchk'a	s.
muchk'ay	v. tr.
muchuy	s. / v. tr.
muchhay	v. tr. Cuz.
much'ay	v. tr. / arc.
muhu	s.
mukiy	v. tr. Cuz.
mukmu	s.
mullak'a	s.
mulli	s.
mullkhu	s. Cuz.
mullmuy	v. tr.
mullphay	v. intr.
munapay	s. / v. tr.
munay	adj. / v. tr.
munthun	s.
muqch'ikuy	v. intr.
muqu	s.
muraya	s.
murq'a	adj.
muru	s.
muruchu	s. / Fig.
muruy	v. tr.
muskhiy	v. tr.
musqhuy	s. / v. tr.
musphay	v. intr.
musuq	adj.
musyay	v. tr.
mut'i	s.
mut'u	adj.
mut'uy	v. tr.
muya	s. arc.
muyu	s. / adj.
muyuy	s. / v. intr.
na	part.
nakay	s. Aya. / v. tr.
nanay	s. / v. intr.
napay	v. tr. Cuz.
nawus	s.
nina	s.
ninri	s. Cuz.
nisyu	adv.
niraq	adv.
niy	v. tr.
nuyu	adj. Aya.
nuyuy	v. tr. Aya.
ña	adv.
ñakay	s. / v. tr.
ñak'ariy	v. intr.
ñak'ay	s. Cuz. / v. tr.
ñan	s.
ñaña	s.
ñaqch'a	s.
ñaqch'ay	v. tr.
ñaqha	adv.
ñawch'i	adj.
ñawi	s.
ñawinchay	s.
ñawpa	adj.
ñawpay	v. intr.
ñawsa	adj. / Fig.
ñit'iy	v. tr.
ñukch'u	s.
ñukñu	adj.
ñuñu	s.
ñuñuy	v. tr.
ñuqa	pron.
ñust'a	arc.
ñuti	s. Aya.
ñutqhu	s.
ñut'u	adj.
ñut'uy	v. tr.
pacha	s.
pachak	num.
pacha-manka	s.
pachas	s.
paka	s.
pakay	v. tr.
pakakuy	v. intr.
pakpaka	s.
palta	s.
paltay	v. tr.
paltay	s.
pallar	s.
pallay	v. tr.
pallay	s.
pampa	s.
pampachay	v. tr. / Fig.
pana	s. Cuz.
pani	s. Aya.
panta	adj.
pantay	v. tr.
panti	s.
pantiyun	s.
paña	adj. Cuz.
papa	s.
paqarin	adv.
paqarina	s.
paqariy	v. intr.
paqay	s.
paqpa	s.
paqta	adv.
paqway	adv. Aya.
paqu	s.
para	s.
paray	v. impers.
pariwana	s.
parlay	v. tr.
parquy	v. tr. Aya.
parwa	s.
parway	v. intr.
pasay	v. intr.
paskay	v. tr. / Fig.
pata	s. / adv.
pataray	v. tr.
pay	pron.
paya	s.
payayay	v. intr.
payqu	s.
pi	pron.
pichana	s.
pichay	v. tr.
pichiwyay	v. intr.
pichqa	num.
pikchu	s.
piki	s.
pilatay	v. intr. Aya.
pillchay	v. tr.
pillpintu	s.
pillu	s.
pincha	s.
pinchi-kuru	s.
pinchiy	v. intr.
pinkullu	s.
piñi	s.
pipu	adj.
pirqa	s.
pirqay	v. tr.
pirwa	s.
pisi	s. / adj.
pisipay	v. intr. Cuz. / v. tr. Aya.
pisiyay	v. intr.
piska	s. Aya.
pisunay	s.
pisqu	s.
pitiy	v. tr.
pituy	v. tr.
piyun	s.
puchu	s.
puchuy	v. tr.
puchka	s.
puchkay	v. tr.
puka	adj.
pukara	s.
pukayay	v. intr.
pukllana	s.
pukllay	s. / v. tr.
pukuchu	s. Aya.
pukyu	s.
pullira	s.
puma	s.
puna	s. Cuz.
punchawyay	v. intr.
punchu	s.
punki	adj.
punkiy	v. intr.
punku	s.
puñuna	s.
puñuy	s. / v. intr.
puñuysa	adj.
pupu	s.
puqti	s. Aya.
puqtuy	s. Cuz.
puqpu	s.
puqpuy	v. intr.
puqu	adj.
puquy	s. / v. intr.
pura	s.
puran	pron.
puriy	s. / v. intr.
puru	s.
purun	s.
purutu	s.
pusaq	num.
pusay	v. tr.
putka	s. Aya.
putquy	s. Aya. / v. tr.
puyu	s. Aya.
puyunkuy	s.
puyuy	v. tr.
phanchi	adj.
phanchiy	v. intr.
phaqcha	s.
phasiy	v. tr.
phaspa	adj.
phaspay	v. intr.
phatachi	s.
phaway	v. intr.
phiña	adj.
phiñakuy	v. intr.
phiruru	s.
phiwi	s.
phukuy	v. tr.
phullpuy	v. intr.
phullu	s.
phuqchiy	v. intr.
phuqtuy	s.
phuru	s.
phuspu	s.
phusu	s.
phusullu	s.
phusuqu	s.
phutiy	v. intr.
phuyu	s.
p'acha	s.
p'aki	adj.
p'akiy	v. tr.
p'allqa	s.
p'alta	adj.
p'ampay	v. tr.
p'anra	adj. Cuz.
p'anqa	s.
p'aqla	adj.
p'aqu	adj.
p'asña	s.
p'atatay	v. intr. Cuz.
p'atay	v. intr. Aya. / v. tr. Cuz.
p'inqay	s. / v. tr.
p'inqakuy	v. intr.
p'isaq	s.
p'istuy	v. tr. Cuz.
p'itay	v. intr. Cuz.
p'ituy	s. / v. tr.
p'uchqu	adj.
p'uchquy	v. intr.
p'uchukay	v. intr.
p'ukru	s. / adj.
p'uku	s.
p'unchaw	s.
p'uyñu	s.
qacha	adj. Cuz. / Aya.
qachiy	v. tr.
qalawala	s.
qallariy	v. tr.
qallu	s.
qallu-qallu	s.
qam	pron.
qamay	v. intr. Aya.
qamya	adj. Aya.
qanchis	num.
qanqa	adj.
qantu	s.
qañiwa	s.
qapariy	v. intr.
qaparkachay	v. intr.
qaqa	s.
qara-chupa	s.
qaray	v. tr.
qaraywa	s.
qara	s.
qaracha	s.
qarpay	s. Cuz.
qarquy	v. tr.
qarwa	adj.
qarwinchu	s. Cuz.
qasa	s.
qasay	v. impers.
qasi	adj. / Fig.
qasiy	v. intr.
qata	s.
qatay	s. Cuz.
qatay	v. tr.
qatichikuy	v. tr.
qatikachay	v. tr.
qatipay	v. tr.
qatiy	v. tr.
qawi	adj. Cuz. / Aya.
qawiy	v. intr. Cuz. / Aya.
qayay	v.
qaykuy	v. tr.
qaylla	adv.
qayna	adv.
qaywa	s.
qaywiy	v. tr.
qichqa	s. Aya.
qichqachiy	v. tr.
qichuy	v. tr.
qilla	s.
qillakuy	v. intr.
qillqa	s.
qillqay	v. tr.
qimllaykachay	v. intr. Aya.
qina	s.
qincha	s.
qipqi	s.
qipu	s.
qiru	s.
qisachay	v. tr.
qispi	s.
qispichiy	v. tr.
qispiy	v. intr.
qisqis	s.
qitya	s. Aya.
qiwa	s. Aya.
qiwlla	s.
qiwña	s.
qiwsuy	v. tr.
qucha	s.
quchay	v. intr.
quchu	adj. Aya.
qulla	s.
qullana	s.
qulla-suyu	s.
qulliy	v. tr.
qullpa	s.
qullqi	s. / arc.
qulluta	s.
qulluy	v. intr.
qunchu	s. / adj.
qunqay	v. intr.
qunqaylla	adv.
qunqur	s.
qunquray	v. intr.
quntay	s.
qunuy	v. tr.
quñiy	v. intr.
qupuy	v. tr.
quqaw	s.
qura	s.
quri	s.
qurpachay	v. tr.
qusa	s.
qutu	s.
qutuy	v. tr.
quwi	s.
quy	v. tr.
quya	s. arc.
quyllur	s.
qhachqa	adj. / Fig.
qhachun	s. Cuz.
qhachwa	s.
qhanra	adj.
qhapaq	adj.
qhapchi	adj.
qhapchuy	v. tr. Cuz.
qhapra	adj.
qhapya	adj.
qhaquy	v. tr.
qhari	s. / Fig.
qhariyay	v. intr.
qharqar	s.
qhasqu	s.
qhasu	adj. Cuz.
qhasuy	v. tr. Cuz.
qhata	s. Cuz.
qhatqi	adj.
qhatu	s.
qhatuy	v. tr.
qhaway	v. tr.
qhawachiy	v. tr.
qhayqay	s. Cuz. / v. intr.
qhichincha	s. Cuz.
qhichipra	s.
qhichwa	s.
qhillay	s.
qhipa	adj.
qhipay	v. intr.
qhuchpay	v. intr.
qhumpu	adj. Cuz.
qhuña	s. Cuz.
qhurquy	v. intr.
qhuru	adj.
qhutuy	v. tr. Cuz.
qhuyu	s. Cuz.
q'achu	s. Cuz.
q'asa	s.
q'ala	adj. / adv.
q'ata	s.
q'apay	s. / v. tr.
q'apiy	v. tr.
q'apñuy	v. tr.
q'aqchay	s. / v. tr.
q'aqway	v. tr. Cuz.
q'aspa	s.
q'aspay	v. tr.
q'ara	adj. Cuz.
q'ayma	adj. Cuz.
q'aytu	s.
q'awa	s.
q'icha	s. / adj. Cuz.
q'ichay	v. tr.
q'illa	s.
q'illu	adj.
q'imiy	v. tr.
q'impiy	v. tr.
q'inqu	adj.
q'inti	s.
q'intiy	v. intr.
q'ipi	s.
q'ipiy	v. tr.
q'isa	s.
q'iswa	s.
q'iwiy	v. tr.
q'iya	s.
q'uchachiy	v. tr.
q'umir	adj.
q'uncha	s.
q'uñi	adj.
q'upa	s.
q'urunta	s.
q'uruta	s.
q'usñi	s.
q'usñiy	v. intr.
q'utu	s.
q'uyu	s.
q'uyuy	v. intr.
q'uya	s. arc.
rachiy	v. tr.
rachuy	v. tr.
raka	s.
raki	s.
raki-raki	s.
rakiy	v. tr.
rakray	v. tr.
rakt'a	adj.
rakhu	adj.
rampa	s. arc.
rampay	v. tr. / arc.
ramphi	s.
rancha	s.
ranka	adj. Aya.
rank'uy	s. Cuz. / v. tr.
ranra	s.
ranti	s.
rantikuy	v. tr.
rantiy	v. tr.
rapra	s.
rap'i	s.
raqacha	s.
raqay	s. / v. intr.
raqra	adj.
raqray	v. intr.
ratay	v. intr.
ratu	s.
ratapa	s. / Fig.
rawi	adj. Cuz.
rawray	v. tr.
raykuy	v. tr.
rikch'akuy	v. intr.
rikch'aq	s.
rikch'ay	s. / v. intr.
rikra	s.
rikuy	s. / v. tr.
rikhuriy	v. intr.
rimay	v. tr.
rinri	s.
ripuy	v. intr.
riqsikuy	s. / v. tr.
riqsiy	v. tr.
riru	s.
rit'i	s.
rit'iy	v. impers.
riy	v. intr.
riyal	s.
ruku	adj.
ruk'ana	s. Cuz.
ruk'i	s. Cuz.
rumi	s.
rumiyay	v. intr.
rumu	s. Cuz.
runa	s.
runayay	v. intr.
runku	s.
runkuy	v. intr. Cuz.
runkhi	adj.
runtu	s. / Fig.
ruphay	s. / v. impers.
ruqru	s.
ruqu	s. Aya.
ruqutu	s.
ruray	s. / v. tr.
ruru	s.
rurun	s.
rusas	s.
rutuchikuy	s.
rutuna	s.
rutuy	s. / v. tr.
ruway	v. tr.
ruyru	adj. Aya.
sach'a	s.
saksa	adj.
saksay	v. intr.
sakway	v. tr. Aya.
sallqa	s. Aya. / Fig.
samay	s. / v. intr.
sami	s.
samkay	s. / v. tr.
samp'a	adj.
sananpa	s.
sankhu	s.
sansa	s.
sapa	s. / pron.
sapallu	s.
sapra	s. Aya.
sapsa	adj.
saphi	s.
saqiy	v. tr.
saqmay	v. tr.
saqra	s. / adj.
saqsa	adj. Cuz.
saqtay	s. Cuz. / v. tr.
sara	s.
saruy	v. tr.
sasa	adj.
sasiy	s. / v. tr.
sat'iy	v. intr. / Fig.
saway	s. Aya. / v. tr.
sawka	s. Cuz.
sawku	s.
sawna	s.
sayariy	v. intr.
sayay	s. / v. intr.
saynata	s.
sayk'uy	v. intr. Cuz.
sayri	s.
saywa	s.
sichus	conect.
siki	s.
sik'iy	v. tr.
sillu	s.
sillwiy	v. tr. Cuz.
simi	s.
simp'a	s.
simp'ay	v. tr.
sinay	v. tr.
sinchi	adj.
sinka	s. / adj.
sinku	s.
siniha	ant.
sinkhay	v. tr.
sinqa	s.
sinq'ay	v. tr.
sipas	s.
sipiy	v. tr.
siplay	v. tr.
siptiy	v. tr. Aya.
sip'u	adj.
sip'uy	v. tr.
siqay	v. tr.
siqi	s. Cuz.
siqsiy	v. tr.
siq'i	s. arc.
siq'uy	v. tr.
siq'ullu	s. Aya.
siray	v. tr.
siriy	v. intr.
sirk'a	s.
sirk'ay	v. tr.
sisa	s.
sisi	s.
sispa	adv.
sit'i	adj.
sitwa	s. arc.
siwar	s.
siwara	s.
siwi	s.
siwuylla	s.
suchkhay	v. intr.
suchuy	v. intr.
such'u	adj.
sukay	v. tr. Aya.
sukullukuy	s.
suk'a	s.
suk'uta	s.
sulla	s.
sullk'a	adj.
sulluy	s. / v. tr.
sumaq	adj.
sunch'u	s.
suni	adj.
sunkha	s. Cuz.
sunqu	s. / Fig.
suntuy	v. tr. Cuz. / Aya.
suñay	s. / v. tr.
supay	s. / arc.
supi	s.
supiy	v. tr.
suphullu	s.
suqu	s.
suqus	s.
suqta	s. num.
suquy	v. tr.
suri	s.
surq'an	s.
suruchi	s.
suruy	v. intr.
susunkay	v. intr.
suti	s.
sut'i	adj.
sut'uy	s. / v. intr.
suwa	s.
suway	v. tr.
suwiq'ara	s. Cuz.
suyay	v. tr.
suysuy	v. tr.
suyt'u	adj.
suyu	s. / arc.
suyuntuy	s.
takarpu	s.
takarpuy	v. tr.
takay	v. tr.
taki	s. / arc.
takiy	v. tr.
taksa	adj.
taklla	s.
takya	s.
takyay	v. intr.
talliy	v. tr.
tampu	s.
tamray	v. tr. Aya.
tanka	s.
tankayllu	s.
tanqay	v. tr.
tantay	v. tr. Cuz.
tantiyay	v. tr.
taparaku	s.
tapuy	v. tr.
taqi	s.
taqmay	v. tr.
taqñuy	v. tr.
taqruy	v. tr.
taqya	s.
tara	s.
taripay	v. tr.
tariy	v. tr.
tarpuy	s. / v. tr.
taruka	s.
tarwi	s.
taspiy	v. tr. Aya.
tatiy	v. tr.
tawa	num.
tawna	s.
tawqay	v. tr.
tayta	s.
taytacha	s.
tika	s.
tikay	v. tr.
tikayay	v. intr.
tikray	v. tr.
tiksi	s. Aya.
tikti	s.
tinkuy	s. / v. tr.
tinya	s.
tipiy	v. tr.
tiqsi	s.
tiqsi-muyu	s.
tiqti	s.
titi	s.
tiyana	s.
tiyay	v. intr.
tuku	s.
tukuy	adj. / v. tr. / v. intr.
tuki	adj. Aya.
tullpa	s. Aya.
tullu	s. / Fig.
tulluyay	v. intr.
tumay	v. tr.
tumpay	v. tr.
tunay	s.
tunkiy	s. / v. tr.
tunqur	s.
tunta	s. Cuz.
tupay	v. intr.
tupqiy	v. tr. Aya.
tupsay	v. tr. Aya.
tupu	s. / arc.
tupuy	v. tr.
tuqllay	s. / v. tr.
tuqra	s. Aya.
tuqtuy	v. intr.
tura	s. Cuz.
turi	s. Aya.
turu	adj. Cuz.
tustun	s.
tusuy	s. / v. intr.
tuta	s.
tutayay	v. impers.
tuya	s.
tuyuy	v. tr. Cuz.
thalta	s. Cuz.
thallay	v. intr.
thami	s. Cuz.
thampiy	v. intr.
thaniy	s. / v. intr.
thanta	adj. Cuz.
thantay	v. intr.
thasnuy	v. intr.
thatkiy	v. intr.
thunkuy	v. tr. Cuz.
thiqtiy	v. tr.
thuñiy	v. intr.
thupay	v. tr.
thuqay	s. / v. tr.
thuta	s.
t'akay	v. tr. Cuz.
t'ampa	s.
t'anta	s.
t'añuy	v. tr. Cuz.
t'apsay	v. tr.
t'aqllay	v. tr.
t'aqsay	v. tr.
t'aqtay	v. tr.
t'aqwiy	v. tr.
t'asqi	s. Cuz.
t'ika	s.
t'iksuy	v. tr.
t'impuy	v. intr.
t'inkay	s. / v. tr.
t'inkiy	v. tr.
t'ipana	s.
t'ipay	v. tr.
t'ipqay	v. tr.
t'ipsiy	v. tr.
t'ipuqyay	v. intr.
t'ipuy	v. intr.
t'iqpay	v. tr. Cuz.
t'iray	v. tr.
t'isay	s. / v. tr.
t'iyu	s.
t'uqpiy	v. tr.
t'uqsiy	v. tr.
t'uqu	s.
t'uquy	v. tr.
t'uqyay	v. intr.
t'urpuy	v. tr. Cuz.
t'uru	s.
t'utura	s.
uchku	s. Aya.
uchkuy	v. tr. Aya.
uchpha	s.
uchu	s.
uchuy	adj. Aya.
uchha	s.
uhu	s.
uhuy	v. intr.
ukucha	s. Aya.
ukuku	s. Cuz.
ukumari	s.
uksiy	v. tr.
ukya	s.
ukhu	adj. / adv. / s.
uliyay	v. tr.
ultu	s. Aya.
ullasku	s. Aya.
ullpu	adv.
ullu	s.
ulluku	s.
uma	s. / Fig.
umachay	v. tr.
umallikuy	v. intr.
umiña	s.
umiy	v. tr.
umphu	adj.
umu	s. arc.
umutu	adj.
unancha	s.
unanchay	v. tr.
unay	s. / adj. / v. intr.
unayay	v. intr.
unchuy	v. intr. Aya.
unkay	v. tr. Aya.
unkuña	s. Cuz.
unkhu	s.
unquy	s. / v. intr.
untiy	v. tr. Aya.
untuy	v. tr.
unu	s. Cuz.
unyay	v. intr. Aya.
uña	adj.
upa	adj. / Fig.
upallay	v. intr.
upi	s.
upiy	v. tr. Cuz.
upyana	s.
upyay	v. tr.
upuy	v. tr. Aya.
uphay	v. tr.
uqa	s.
uqi	adj.
uqllay	s. / v. tr.
uquti	s.
uray	s. / v. intr.
urin	adv.
uriy	v. tr. Cuz.
urku	s.
urmay	v. intr.
urpay	s. Aya.
urpi	s. Cuz. / Fig.
urpu	s.
urqu	s. / adj.
uru	s.
urwa	adj.
usa	s.
uskakuy	v. tr.
usqullu	s. / Fig.
usthuy	v. intr.
ususi	s.
usuta	s.
usuy	v. intr.
usyay	v. intr. / v. tr.
utiy	s. / v. intr.
utkhu	s.
utqhay	v. intr.
utu	s. adj.
utulu	s. Aya.
uturunku	s.
utus-kuru	s.
uwiha	s.
uya	s.
uyariy	v. tr.
uyniy	v. tr. Cuz. / Aya.
uynu	s. Cuz.
uytu	s. Aya.
uywa	s. / adj.
uyway	v. tr.
wachay	v. tr.
wachwa	s.
wach'i	s.
wach'iy	v. tr. / Fig.
wach'uy	adj.
wak	pron. / adj. Cuz.
waka	s.
waka	s.
wakatay	s.
wakcha	adj.
wakin	pron.
wakri	s. Aya.
waku	s.
wakway	v. intr.
wak'a	s. Cuz. / Fig.
waltha	s. Cuz.
wallata	s.
wallpa	s.
wallqa	s.
wallqay	v. tr.
wallwa	s.
wallwak'u	s.
waman	s.
wamani	s.
wamanripa	s.
wamaq	adj.
wamp'u	s.
wamp'uy	v. intr.
wanaku	s. / Fig.
wanay	v. intr.
wanka	s. arc.
wankar	s. Cuz.
wankuy	v. tr.
wank'a	s.
wank'iy	v. tr.
wanllay	v. tr.
wamp'ar	s.
wanquyru	s.
wantuy	v. tr.
wanthi	s.
wanyay	v. intr.
wanu	s.
wanuy	v. tr.
wanwa	s.
wañu	s.
wañuchiy	v. tr.
wañuy	s. / v. intr.
wapsi	s.
wapsiy	v. impers.
waqati	adj.
waqay	s. / v. intr.
waqaychay	s. / v. tr.
waqra	s.
waqsa	s.
waqta	s.
waqtay	v. tr.
waqu	s.
waqyay	v. tr. Cuz.
wara	s.
warachikuy	s. / v. tr.
waranqa	num.
warak'a	s.
warku	s. arc.
warkuy	s. / v. tr.
warma	s.
warmi	s.
waru	s.
wasa	s. / adv.
wasanchay	v. tr.
wasi	s.
waskha	s.
wask'a	adj.
wata	s.
watay	v. tr.
watiqay	s. / v. tr.
watu	s.
watuchiy	v. tr.
watukuy	v. tr.
watuy	v. tr.
watya	s.
wawa	s.
wawqi	s.
waya	adj.
wayaqa	s.
wayaw	s.
waqlliy	s. / v. intr. / Fig.
waykay	v. tr.
waykuy	v. intr.
wayk'uy	v. tr.
waylla	s.
waylluy	v. tr.
wayna	s.
wayq'u	s.
wayra	s.
wayrunqu	s.
wayruru	s.
wayta	s.
wayt'ay	v. intr. Cuz.
wayunka	s.
wayuy	v. intr.
wichay	s. / v. intr.
wichichichiy	v. intr. Cuz.
wichiy	v. intr.
wichq'ay	v. tr.
wikapay	v. tr.
wikch'uy	v. tr.
wiksa	s.
wiksu	adj.
wik'uña	s.
willakuy	s.
willay	v. tr.
willka	s.
willka	s.
willma	s. Cuz.
winku	s. / adj.
winay	s. / v. tr.
wiñapu	s.
wiñay	s. / v. intr.
wiqaw	s.
wiqi	s.
wiqru	s.
wiqru	adj.
wiqti	s. Aya.
wira	s. / adj.
wiraqucha	s. / arc.
wirp'a	s.
wiru	s.
wischuy	v. tr. Aya.
wisiy	v. tr.
wisk'acha	s.
wislla	s.
wist'uy	s. / v. intr.
wisyay	v. tr.
wiswi	adj.
wit'uy	v. tr.
yachachiy	s. / v. tr.
yachakuy	v. intr.
yachapayay	v. tr.
yachay	s. / v. tr.
yaku	s. Aya.
yalliy	v. tr. Cuz.
yana	s. / adj.
yanapay	v. tr.
yanasa	s.
yankiy	s. / v. tr.
yanqa	adv.
yanta	s. Aya.
yanuy	s. Aya. / v. tr.
yapa	s.
yapay	v. tr.
yapuy	v. tr.
yaqa	adv.
yarawi	s.
yarqay	s. / v. tr.
yarqha	s.
yawar	s.
yawri	s.
yawray	v. intr.
yaya	s. / arc.
yaykuy	v. intr.
yukay	v. tr. Cuz.
yukra	s.
yumay	s.
yunka	s.
yupana	s.
yupay	s. / v. tr.
yupaychay	v. tr.
yupiy	s. / v. intr.
yura	s.
yuraq	adj.
yuriy	v. impers. / v. intr.
yutu	s.
yuyaq	s. / adj.
yuyay	s. / v. tr.
yuyu	s.
